
NO ./maps/default.cub
SO ./maps/default.cub
WE ./maps/default.cub
EA ./maps/default.cub

F 220,100,0
C 225,30,0

1111111111111111111111111
1000000000110000000000001
1011000001110000000000001
100100000000000000000000111111111
111111111011000001110000000000001
100000000011000001110111111111111
11110111111111011100000010001
11110111111111011101010000001
11000111111010111000000100011
100001111000001100000000111111
1000000000000000110101000011
1100100111010101111101111S11
11110111 1110101 10111111111
11111111 1111111 111111111111