NO textures/blue_wall.png
SO textures/colorstone.png
WE textures/redbrick.png
EA textures/wood.png

C 50,100,200
F 0,150,00

111111111111111
100000111000001
100000000000011
100000000000001
1000CCCCC00L0L1
1000000000LL001
10000CC000CLC01
1110000000CNC11
111111111111111