
NO textures/blue_wall.png
SO textures/colorstone.png
WE textures/redbrick.png
EA textures/wood.png


F 220,100,0
C 225,30,0

111111
10S001
100101
100001
100001
100001
111111