
NO textures/wood.png
SO textures/wood.png
WE textures/wood.png
EA textures/wood.png

F 220,100,0
C 225,30,0

1111111111111111
1000000000000001
1000000000000001
1000000000000001
1000000100010001
1000000100010001
1000100000000001
1000000000000001
1000100000010001
10000000000000N1
1111111111111111