NO textures/blue_wall.png
SO textures/blue_wall.png
WE textures/blue_wall.png
EA textures/blue_wall.png

F 220,100,0
C 225,30,0

111111111111111111111111
100000000000000000000001
100000000000000000000001
111111111011111110000001
100000010000000000000111
100000010000000000000001
100000010000011111100001
100000010000000000000001
100000010000000000000001
100000010000000000000001
100000010000111111100001
100000010000000000000011
110000010000011111100001
100000010000000000000001
100000010000000000000001
100000000000000000000001
100000000000000000000001
1000000000000N0000000001
111111111111111111111111 