
NO textures/text3.png
SO textures/text3.png
WE textures/text3.png
EA textures/text3.png

F 10,100,0
C 10,30,0

111111111
110000011
100000001
100000001
100000001
100000001
100000L01
1N00C0011
111111111