
NO ./maps/default.cub
SO ./maps/default.cub
WE ./maps/default.cub
EA ./maps/default.cub

F 220,100,0
C 225,30,0

1111111111111
1111111111111111111111111
1000000000110000000000001
1011000001110000000000001
100100000000000000000000111111111
111111111011000001110000000000001
100000000011000001110111111111111
11110111111111011100000010001
11110111111111011101010000001
11000111111010111000000100011
10000111100000110000001011111
10000000000000001101010011111
11001001110101011111011111S011
11110111 1110101 1011111111111
11111111 1111111 111111111111