
NO ./maps/default.cub
SO ./maps/default.cub
WE ./maps/default.cub
EA ./maps/default.cub

C 0,0,150
F 0,150,00

111111111
100000001
1000S0001
111000111
111111111