
NO ./maps/default.cub
SO ./maps/default.cub
WE ./maps/default.cub
EA ./maps/default.cub

F 220,100,0
C 225,30,0

111111111
100000001
1000S0001
111000111
111111111