
NO ./maps/default.cub
SO ./maps/default.cub
WE ./maps/default.cub
EA ./maps/default.cub

F 220,100,0
C 225,30,0

111111111111111111111111
100000000000000000000001
100000000000000000000001
100000000000000000000001
100000010000000000000001
100000010000000000000001
100000010000011111100001
100000010000000000000001
100000010000000000000001
100000010000000000000001
100000010000111111100001
100000010000011   1100001111111111
1100000100000111111000000000000011
1000000100000000000000011111111111
100000010000000000000001
100011110000000000000001
100000000000000000011111
100000000000000000000001
100000000000000000000001
100000000000000000000001
100000000000000000000001
1000000000000N0000001111
100000000000000000000001
100000000000000000000001
100000000000000000000001
111111111111111111111111