
NO ./maps/default.cub
SO ./maps/default.cub
WE ./maps/default.cub
EA ./maps/default.cub

F 220,100,0
C 225,30,0

1111111111111111
1000000001001001
100S00000100001
1000000001000001
1000000001000001
1000000001000001
1111111111111111