NO textures/blue_wall.png
SO textures/blue_wall.png
WE textures/blue_wall.png
EA textures/blue_wall.png

F 10,100,0
C 10,30,0

1111
1101
1S11
10011
01101
11111