NO textures/blue_wall.png
SO textures/blue_wall.png
WE textures/blue_wall.png
EA textures/blue_wall.png

111111111
10S000001
100000001
100000001
100010001
100000001
100000001
100000001
111111111

F 10,100,0
C 10,30,0
