NO textures/blue_wall.png
SO textures/colorstone.png
WE textures/redbrick.png
EA textures/wood.png

C 50,100,200
F 0,150,00

111111111111111
100000111200001
1000000S0000001
100000000000001
100000000000001
100000000000001
100000000000001
111000000000111
111111111111111